#W = Wall, T = Terrain, V = Void, L = Left, R = Right, P = Player Origin
16 11
WVWWWWWWWWWWWWWW
WRTTPTTTVTTVTTRV
WTWWWWWWWWWWWWTW
WTWVVVVVVVVVVWTW
WVWVVVVVVVVVVWTW
WTWVVVVVVVVVVWTW
WTWVVVVVVVVVVWVW
WTWWWWWWWWWWWWTW
VRTTTTTVTTTTTTLW
WWWWWWWWWWWWWWVW