#W = Wall, T = Terrain, V = Void, L = Left, R = Right, P = Player Origin
24 11
WVWWWWWWWWWWWWWWVVVVVVVV
WRTTPTTTVTTVTTRVVVVVVVVV
WTWWWWWWWWWWWWTWVVVVVVVV
WTWVVVVVVVVVVWTWWWWWWWWW
WVWVVVVVVVVVVWLTTTTTTTRV
WTWWWWWWWWWVWWVWWWWWWWTW
VRTTTTTTTTTLWVVVVVVVVWTW
WWWWWWWWWWWTWVVVVVVVVWVW
VVVVVVVVVVWTWWWWWWWWWWTW
VVVVVVVVVVVRTTTTVTTTTTRW
VVVVVVVVVVWWWWWWWWWWWWVW